%%%%%%%%%%%%%%%%%%%%%%%%%%%%%%%%%%%%%%%%
% %     %       %    %  % %       %    %
%%%% %%    %    %    %%%     %%      %%%
%    %            %% %     %   %  %%%% %
%%%     %% % %%   %  % % %%%% % %  %   %
% % %  %% %   %%  %            % %%%   %
%   % %   %    % %   %    %  % %  % % %%
%  %%%      %   %     % % %  %  % % %% %
%    %%%% %  %%     %  % %    % % %    %
% %   %     %  %%%      % %            %
%       %  %  %%   %%% %   %%%%      % %
%  %%  %   %  %   %  %%     %  %  %  %%%
%   %  %   %  %% %   % %%    %         %
% %         %% %%   %      %  %  %     %
% %    % %% %  %  % %%     % %     %   %
%  % % %%      %   %% %  %   %%     %  %
%   %% % %      %  % %   % %%% %% %%% %%
%%  %  %      %%   %      % %   %   %  %
% %      %%  %% %   % %% %             %
%     % %%   %  %%%% %%       %%  %    %
% % %   % % %%   %   %  % %% %%  %%   %%
%           % %%   %   %%%%  %    % %% %
%  % %   %     %% %   %    %%  %% %    %
%    %   %%  %    %  %%%    % %% P%    %
% %%    %        % %%      %% %  %%%% %%
%   %  % % % % % %%   %    % %%%       %
%% %%    %%           %% % %   %     %%%
%  %          %%%   %   %  %   %       %
%%%%       %%%    %% %  %%%     %    % %
%  %  % %   %    %    %     %% %   %   %
%%  %  %    % % % %%%%%   %% % %% %%  %%
%  % %    %% %     % % % % %     %%    %
%    %    % %   %%   %%%% %%  % % %%%  %
%% %%%%%  % % % % %         %   %  %  %%
%         %%%%%%%  %%              %%  %
% % %            %  % %%   %%  %   % %%%
% %     % %           %   %%   %  % %% %
% % % %  %%%%  %  %  %% %      %    %  %
%.     % %  %%  % %  %      %          %
%%%%%%%%%%%%%%%%%%%%%%%%%%%%%%%%%%%%%%%%
